   1111111111
  11    1   1
 11     3  41
11  1 3 1   1
12  1   11111
11111   1    
    1 3 1    
    11111    