   1111111111111
  11    1   3131
 11     3  11  1
11  1 3 1     11
12  1   131 111
11111   1 1 3 1
    1 3 1  1 31
    11111 31411
        111111    