11111111111
1111    1 1
111     3 1
11  1 3 1 1
12  1   131
11111   1 1
11111 3 1 1
11111111141
11111111111