1111111111
12    1111
1   1 1111
1   1   31
111 113  1
111  1   1
111      1
111  11111
111 411111
1111111111