1111111111
12       1
1 1  131 1
1        1
1  1   1 1
1        1
13  13 1 1
1        1
131 31 141
1111111111