########
#q00000#
#000000#
#000000#
#000000#
#000000#
#000000#
########