1111111   
12    1   
1   1 1111
1   1   31
111 113  1
  1      1
  1 411111
  1111    